10.ox
.o........
oooo......
...o..o...
..........
o.oo......
.....o....
.......o..
......o.o.
..........
..........
